NO ./path_to_the_north_texture
SO ./path_to_the_south_texture
EA ./path_to_the_east_texture
WE ./path_to_the_west_texture
F 220,100,0
C 225,30,0
111111111111111111111111
1000000000000010000000001
100001111110000000000000000000001
100100000000000000000000111111111
100001000000000000000000000000001
111111111111111111111111111111111
